NO ./textures/north.xpm
SO ./textures/south.xpm
WE ./textures/west.xpm
EA ./textures/east.xpm

F 42,42,42
C 69,169,255







111111111111
10       001
10       001
1N       001
111111111111