NO ./textures/north.xpm
SO ./textures/south.xpm
WE ./textures/west.xpm
EA ./textures/east.xpm

F 139,69,19
C 135,206,235


111111111111111111111111111111111111111111111111111111111111
111111111111111111111111111111111111111111111111111111111111
110000000000000000000000000000000000000000000000000000000011
1100S0000000001111111111111111110000011111111111111111000011
110000000000000000000000000000000000000000000000000000000011
110000000011000001111111111111011111111111111111111000000011
110000000011000001111111111111001111111111111111111000000011
110001111111000001111111111111101111111111111111111000000011
110001000001000000000000000000000000000000000000000000000011
110001011101111111110000000000111111111111111111111111100011
110001000001000000000000000000000000000000000000000000000011
110001111111000001111111111111111111111111111111111011110011
110000000011000001111111111111111111111111111111111000000011
110000000011000000000000000000000000000000000000000000000011
110000000011000001111111111111110001111111111111111000000011
110001111111000001111111111111110001111111111111111000000011
110001000001000000000000000000000000000000000000000000000011
110001000001000000000000000000000000000000000000000000000011
110001000001000000000000000000000000000000000000000000000011
110001000001000000000000000000000000000000000000000000000011
110001111111000001111111000011111111111111111111111011110011
110000000011000001111111000011111111111111111111111000000011
110000000011000000000000000000000000000000000000000000000011
110000000011000001111111111111111111111111111111111000000011
110001111111000001111111111111111111111111111111111000000011
110000000001000000000000000000000000000000000000000000000011
110001010101111111111111111111111111111111111111111111100011
110001000001000000000000000000000000000000000000000000000011
110001111111000001111111111111111111111111111111111011110011
110000000011000001111111111111111111111111111111111000000011
110000000011000000000000000000000000000000000000000000000011
111111111111111111111111111111111111111111111111111111111011
111111111111111111111111111111111111111111111111111111111011
111111111111111111111111111111111111111111111111111111111111
